R 1000 1080
NO ./textures/stone.xpm
SO ./textures/bluestone.xpm 
WE ./textures/mossy.xpm
EA ./textures/wood.xpm
S ./textures/barrel.xpm

F 0,255,255
C 100,30,0

        1111111111111111111111111
        1000000000110000000000001
        1011000001110000021200001
        1001000000000000021200001
111111111011000001110000210200001
100000000011000001110111110111111
11110111111111011100000010001
11110111111111011101010020N01
110000001101010111000000100011      111111
100020000000000011000000000111      100001
10000000000000001101010010001      111111
1100000111010101111101111000111
11110111 1110101 101111010001
11111111 1111111 111111111111